EDITCUSTINFO=EditCustInfo
UPDATESSN=UpdateSSN
PHYSICALDESCRIPTION=View PhysicalDescriptionTab
EDITPHYSICALDESCRIPTION=Edit PhysicalDescriptionTab
EDITGOVTIDTYPEAGENCY=EditGovtIDTypeAgency
EDITGOVTIDNUMBER=EditGovtIDNumber
OVERRIDE=Override
NEWPAWNLOAN=NewPawnLoan
EDITCOMMENTS=EditComments
SERVICES=Services
BUY OUT=Buy Out
BANKRUPTCYHOLD=BankruptcyHold
CUSTOMERHOLDS=CustomerHold
PFICREATELIST=CreatePFIListPanel
PFIVERIFY=PFIVerifyPanel
PFIPOST=PostPFIActivityPanel
CHARGEOFF=ChargeOff
POLICE_ACTIVITIES=PoliceActivitiesAll
POLICE RESTITUTION ONLY=Police Restitution Only
PRINTPFIMAILER=PrintPFIMailer
REPRINTTAGS=ReprintTags
UPDATE USER PROFILE RESOURCES CURRENT LOCATION ONLY=Update User Profile Resources Current Location Only
UPDATE USER PROFILE RESOURCES MULTIPLE LOCATIONS=Update User Profile Resources Multiple Locations
MANAGE LIMITS / RESOURCES=Manage Limits / Resources
TRANSFEROUT=TransferOut
VOIDTRANSACTION=Void Transactions and Services
VIEWREFERENCENUMBER=ViewReferenceNumber
MANUAL ENTRY=Manual Entry
PAWN LOAN INQUIRY CURRENT LOCATION=Pawn Loan Inquiry Current Location
PAWN LOAN INQUIRY MULTIPLE LOCATIONS CURRENT REGION=Pawn Loan Inquiry Multiple Locations current Region
PAWN LOAN INQUIRY MULTIPLE LOCATIONS CURRENT MARKET=Pawn Loan Inquiry Multiple Locations current Market
PAWN LOAN INQUIRY ALL LOCATIONS=Pawn Loan Inquiry All Locations
PRINT GUN BOOK IN CURRENT LOCATION=Print Gun Book in Current Location
PRINT GUN BOOK IN ANY LOCATION=Print Gun Book in Any Location
EDIT GUN BOOK=Edit Gun Book
EDIT RESTRICTED GUN BOOK FIELDS=Edit restricted Gun Book fields
CASH TRANSFER=Cash Transfer
REDESCRIBE MERCHANDISE=Redescribe Merchandise
PRINT SECURITY BARCODE=Print Security Barcode
SHOPADMINMENUCONTROL=shopadminmenucontrol
SAFEMANAGEMENT=Safe Management
CUSTOMERBUY=Customer Buy
VENDORBUY=Vendor Buy
RETURNCUSTOMERBUY=Return Customer Buy
EDITVENDOR=Vendor Edit
SNAPSHOT=Snapshot
SNAPSHOT MULTIPLE LOCATIONS=Snapshot Multiple Locations
DETAIL INVENTORY=Detail Inventory
ASSIGNITEMPHYSICALLOCATION=Locate Merchandise
FULL LOCATIONS=Full Locations
DETAIL GUN AUDIT=Detail Gun Audit
RETAILDISCOUNTPERCENT = Retail Discount Percentage
DEVRESOURCE=DevResource
LAYAWAY_NUMBER_INCREMENT_LIMIT = Layaway Number Increment Limit
CHANGERETAILPRICE=Manage Inventory Pricing
RETURNVENDORBUY=Return Vendor Buy
RETAILSALEREFUND=Retail Sale Refund
LAYAWAYPAYMENTREFUND=Layaway Payment Refund
AuditAppAccess=AuditAppAccess